1111111111111111111111111111111111
1E000000000000000010000000000000C1
101000000000000001000000S0000000C1
101000000000000001000000S0000000C1
1P1000000000000001000000S0000000C1
100000000000000001000000S0000000C1
111000000000000001000000S0000000C1
100000000000000000000000S0000000C1
10100000000000S0010C0000S0000000C1
101000000000000001000000S0000000C1
1111111111111111111111111111111111