1111111111111111
10E0111111111111
1CP0111111111111
1000001000000011
1000000000000011
1000001000000011
1000001000000011
100C001000000011
100CSS1000000011
100C0S1000000011
10CC0S1000000011
1SSSSC1000000011
1111111111111111