1111111111111111
10E0111111111111
1CP0111111111111
1000001111111111
1000001111111111
1000001111111111
1000001111111111
100C001111111111
100CSS1111111111
100C0S1111111111
10CC0S1111111111
1SSSSC1111111111
1111111111111111