111111111111111111111111111
100000000000000000100000001
101000000000000001000000001
101000000000000001000000001
1P1000000000000001000000001
100000000000C00001000000001
111000000000000E01000000001
100000000000000000000000001
10100000000000S001000000001
101000000000000001000000001
111111111111111111111111111