1111111111111111
10E0000000000011
1C10000000000011
1C10000000000011
1C00000000P00011
1C00000000000011
1S0000000SSSS011
1111111111111111