1111111111111111
10E0111111111111
1CP0111111111111
1000001000000011
10000000S0000011
1000001000000011
1000001000S00S11
100C001000S00S11
100C001000S00S11
100C001000S00S11
10CC001000S00S11
1000001000000011
1111111111111111