1111111
10E0111
1CP0111
1000001
1000001
1000001
1000001
100S001
1000001
10000C1
10000C1
10000C1
1111111