1111111111111111111111111
1CEP111CEP111CEP111CEP111
1011111011111011111011111
1011111011111011111011111
1000001000001000001000001
100000100S0010C0001000001
1000001000001000001000001
10000010S00010C0001000001
1S000010S00010000S1000001
1111111111111111111111111