1111111111111111111111111111111111
1E0000000000000000000000S0000000C1
1010000000000C0001000000S0000000C1
101000000000000001000000S0000000C1
1P0000000000000001000000S0000000C1
1010000000000000S1000000S0000000C1
101000000000000001000000S0000000C1
100SS0000000000000000000S0000000C1
1010000S00000000010C0000S0000000C1
101000000000000001000000S0000000C1
1111111111111111111111111111111111