1111111111111111111111111111111111
1E000000000000000000000000000000C1
1010000000000C000000000000000000C1
10100000000000000000000000000000C1
1P000000000000000000000000000000C1
1010000000000000S000000000000000C1
10100000000000000000000000000000C1
10000000000000000000000000000000C1
1010000000000000000C000000000000C1
10100000000000000000000000000000C1
1111111111111111111111111111111111