1111111111111111111111111111111111
fE0000000000000C00000C000000000001
1010010100100000101001000000010101
1010010010101010000001000000010101
1P0000000C00C0000000000000000000C1
1111111111111111111111111111111111