111111111111
1CCCCCCCCCE1
1CCCCCCCCCC1
100000000001
1000000P0001
100000000001
100000000001
100000000001
100000000001
100000000001
100000000001
1SSSSSSSSSS1
1SSSSSSSSSS1
111111111111